******P********b
***************b
**************pt
**************bi
**************bi
n*************hu
a**************b
a**************b
rn*************b
ia*************b
so*************b
a**************b
re******1******b
ia************gt
irce*********gti
iisf********mdui
sdf****1******bi
a*************qu
a****1*********b
re*************b
ia*************b
ia*************b
irn*******1****b
iia************b
iire***********b
iiia***********b
iiso***********b
iia************b
iso************b
ia*************b
