*******P*****P**a
****************a
****P*****P****aa
***************aa
***************aa
a**************aa
a***************a
a***************a
aa**************a
aa**************a
aa**************a
a***************a
aa**************a
aa*************aa
aaaa**********aaa
aaaa*********aaaa
aaa************aa
a**************aa
a***************a
aa**************a
aa**************a
aa***1*****1***aa
aaa************aa
aaa*************a
aaaa************a
aaaa************a
aaaa************a
aaa*************a
aaa*************a
aa*******1******a
a***************a
a***************a
a***************a
aa*************aa
aaa***********aaa
a*a*****2******aa
a**************aa
aa*************aa
aaa************aa
a***************a
a***************a
a***************a
a**************aa
a*******2******aa
a**************aa
a***************a
aa***************
aaaa*************
aaa**************
a***********2***a
a***************a
a***************a
aa**************a
a**************aa
a***************a
a***************a
a***************a
a***************a
a****2***********
aaa**************
aaaaa************
a*aaaaaa*********
a****aaaa***1****
a****************
a***************a
a***************a
a***************a
a***************a
aa*************aa
aa*************aa
aa**************a
a***************a
a************aaaa
a*************aaa
a***************a
aa***3**********a
aa**************a
aa**************a
a***************a
a***************a
a*************aaa
a**************aa
a**************aa
a***************a
aa************aaa
aa**************a
aa**************a
a***************a
aa**************a
aa**************a
aa**************a
aa************aaa
aa*************aa
a********3******a
a***************a
a***************a
a***************a
a***************a
aa*************aa
aa*************aa
a**************aa
a***************a
aa**************a
aa**************a
aaaa************a
a**************aa
a**************aa
a**************aa
a*************aaa
a***************a
aa****4*********a
aa*************aa
a***************a
a***************a
a****************
a*******a********
a*****aaaa*******
a******aa********
a******a********a
a***************a
aa**************a
aa************aaa
aa*************aa
a***************a
a***************a
a***************a
aa**************a
*****************
