******P*****P**aa
***************aa
****P****P****aaa
**************aaa
**************aaa
a*************aaa
a**************aa
a**************aa
aa*************aa
aa*************aa
aa*************aa
a**************aa
aa*************aa
aa************aaa
aaaa*********aaaa
aaaa********aaaaa
aaa***********aaa
a*************aaa
a**************aa
aa*************aa
aa*************aa
aa*************aa
aaa************aa
aaa************aa
aaaa***********aa
aaaa***********aa
aaaa***********aa
aaa************aa
aaa***1*1*1*1**aa
aa*************aa
a***************a
******1*********a
***********1****a
***1************a
****************a
*******2**2*****a
***************aa
****2******1***aa
a***************a
a***************a
***1*****1******a
***************aa
******1***1***aaa
***************aa
a*******3******aa
***********1****a
******1**1******a
a***************a
a***************a
a***2**2**2**2**a
a****************
aa***1******1****
aa***************
aaa****3**1******
a****************
a***********3****
a*******2********
****1************
**********2*****a
*****1**1***1***a
a****************
a***2******2*****
a*********1******
a****************
a******3**3******
a***************a
aaa*************a
aa*****1*1*1****a
a***************a
aa*************aa
aa*****1****1**aa
aa*************aa
a****1***1****aaa
a**************aa
a***************a
a***2***3**3****a
a***************a
a***************a
a*****2***3*****a
a****2**2**2****a
****************a
********a***3***a
a******aaa*******
a*******aa*******
a********aa******
a*****aaaaaa*****
a*****aaa********
a*****a*********a
a*****aa********a
a******a********a
a**2***a********a
a******aa****2**a
a*2*2***a******aa
a*******a***2**aa
a*******aa****aaa
a****1***a*1**aaa
a********a*****aa
aa******aa******a
aa*****aa***3***a
aa*****a********a
a***************a
a**************aa
a**************aa
a***2*3**3*****aa
a*********2**2**a
a**2*2**********a
aa******4***2***a
aa**************a
aaaa************a
a***************a
a***************a
a****1****aaa***a
aaa*****1***aaaaa
aaaaa*********aaa
a**aaaaa********a
a*****aaa*******a
a***************a
a***************a
a***************a
aaa*************a
aaaa***********aa
aa**************a
a**********2*2**a
a***************a
a***************a
a**************aa
a**************aa
a**1**1**1**1*aaa
a*************aaa
a***2**2**2****aa
a***************a
aa***1**1**1****a
aa**************a
aa**************a
a***************a
a***************a
a***************a
aa****3*3*3****aa
aa***********aaaa
aa************aaa
aa**************a
a***************a
a***************a
a***************a
a*****4**4*******
a***1**1****1****
a****1****1******
a**1****1***1****
aa***************
aa****2**2**2****
aa**2**2**2**2***
aaa**************
aa**************a
a***************a
a***************a
a***************a
a**************aa
a**************aa
a*************aaa
a**************aa
a***************a
aa**************a
aa**************a
aa**************a
aa**************a
a***************a
a***************a
a*******A******aa
a**************aa
*****************
*****************
*****************
*****************
*****************
*****************
****************b
****************b
b***************b
b**************bb
b**************bb
b**************bb
b***************b
b***************b
b***************b
b***************b
b***************b
b***************b
b***************b
bbbbb*******bbbbb
b***************b
b***************b
b*****f***f*****b
b*******f*******b
b***bbbbbbbbb***b
bh**************b
b**************gb
bh**************b
b*************g*b
bh**************b
b************g**b
b***************b
bbbb*********bbbb
b**bbb*****bbb**b
b****bb***bb****b
bh**************b
b***************b
bbb***********bbb
b***************b
b***************b
b***************b
b***************b
b***ff*ff*ff****b
b***************b
b**h**h**h**h***b
b***************b
b***************b
b**bbbbbbbbbbb**b
b**b************b
b**b************b
bh*b************b
b**bh********f**b
b**b****f*******b
bh*b************b
b**b******f*****b
b**bh***********b
b**b****f*******b
b**b************b
b**b********f***b
b**b************b
b**b****f*******b
bh*b**********f*b
b**b************b
bggbbbb*****f***b
b*****bb********b
b******b********b
b******bbb******b
bh*******b******b
b***************b
b*f*******g**g**b
b*****f**b******b
b********b******b
b***f****b******b
b*f******bb*****b
b**f*f****b*g*g*b
b***************b
b***************b
b***************b
b**bb*******bb**b
b***************b
b******bbb******b
b***************b
b**b*********b**b
b**bb*******bb**b
b***bbb***bbb***b
b***b*******b***b
b***************b
b*******b*******b
b**b***bbb***b**b
b***************b
b***************b
b***************b
b***************b
b****g*****g****b
b***************b
b***************b
b*h*h*h*h*h*h*h*b
b***************b
b***************b
b***************b
b**i****i****i**b
b***************b
b***************b
bb*************bb
bbbb*********bbbb
bbbbbb*****bbbbbb
bb*************bb
b***************b
b***************b
b***************b
b*f*ff*fff*ff*f*b
b***************b
b***g*g***g*g***b
b**h****h****h**b
b***************b
*****************
*****************
*****************
*****************
*****************
*****************
*****************
*****************
*****************
*****************
*****************
*****************
*****************
*****************
*****************
*****************
*****************
*****************
*****************
*****************
*****************
*****************
********B********
*****************
*****************
*****************
*****************
*****************
*****************
*****************
*****************
**P***P***P***P**
*****************
*****************
c***************c
c***************c
c***************c
cc*************cc
cc*************cc
cc*************cc
ccc***********ccc
ccc***********ccc
ccc***********ccc
cccc*********cccc
cccc*********cccc
cccc*********cccc
ccccc**k*k**ccccc
ccccc*******ccccc
ccccc*******ccccc
cccccc*****cccccc
cccccc*****cccccc
cccccc*****cccccc
ccccc*******ccccc
cccc*********cccc
ccc****k*k****ccc
cc*************cc
c*****l*l*l****c
*****************
*****************
*****************
*****************
*****************
**l**k*k*k*k**l**
*****************
*****************
**m**m**m**m**m**
*****************
*****************
*******ccc*******
*****************
***ccc*****ccc***
*****************
cc*************cc
*****************
*****************
*****************
***n***n*n***n***
*****************
*****************
*k*k*k*k*k*k*k*k*
*****************
l*l*l*l*l*l*l*l*l
*****************
*m*m*m*m*m*m*m*m*
*****************
**n**n**n**n**n**
*****************
*****************
*****************
*****************
*****************
*****************
*****************
*****************
*****************
*****************
*****************
*****************
*****************
*****C*****C*****
*****************
ccccccccccccccc*c
ccccccccc*******c
ccccccccc**cccccc
ccc********cccccc
ccc**cccccccccccc
*****************
