******P********a
***************a
**************aa
**************aa
**************aa
a*************aa
a**************a
a**************a
aa*************a
aa*************a
aa*************a
a**************a
aa******1******a
aa************aa
aaaa*********aaa
aaaa********aaaa
aaa****2******aa
a*************aa
a****3*********a
aa*************a
aa*************a
aa*************a
aaa*******4****a
aaa************a
aaaa***********a
aaaa***********a
aaaa***********a
aaa************a
aaa************a
aa*************a
****************
