******P*****P**a
***************a
****P****P****aa
**************aa
**************aa
a*************aa
a**************a
a**************a
aa*************a
aa*************a
aa*************a
a**************a
aa*************a
aa************aa
aaaa*********aaa
aaaa********aaaa
aaa***********aa
a*************aa
a**************a
aa*************a
aa*************a
aa*************a
aaa************a
aaa************a
aaaa***********a
aaaa***********a
aaaa***********a
aaa************a
aaa************a
aa****1********a
aa*************a
aa*************a
aa*************a
aa*************a
aa*************a
a*************aa
a*************aa
a*************aa
a*************aa
aa*************a
aa*************a
a*************aa
a*************aa
a*************aa
aa*************a
aa*************a
aa*************a
a*************aa
a*************aa
a*************aa
a*************aa
a************aaa
a************aaa
a***********aaaa
a***********aaaa
a************aaa
a*************aa
a**************a
aa*************a
aa*************a
aa*************a
a**************a
a**************a
a**************a
a*************aa
a*************aa
a*************aa
a*************aa
a*************aa
aa*************a
aa*************a
aa*************a
aa*************a
aa*************a
aa*************a
a*************aa
a***********aaaa
a*************aa
a**************a
a**************a
aa*************a
a**************a
a*************aa
aa*************a
aa*************a
a*************aa
a*************aa
a*************aa
a*************aa
a*************aa
aa************aa
aa************aa
aa************aa
aaa************a
****************
