******P*****P**a
***************a
****P****P****aa
**************aa
**************aa
a*************aa
a**************a
a**************a
aa*************a
aa*************a
aa*************a
a**************a
aa******1******a
aa************aa
aaaa*********aaa
aaaa********aaaa
aaa****1******aa
a*************aa
a****1*********a
aa*************a
aa*************a
aa*************a
aaa*******1****a
aaa************a
aaaa***********a
aaaa***********a
aaaa***********a
aaa************a
aaa************a
aa*************a
****************
