**P*P*P*P**
***********
***********
***********
***********
n**********
a**********
a**********
rn*********
ia*****1***
so*********
a**********
re*********
ia*********
irce*******
iisf*******
sdf**1**1**
a**********
a**********
re*********
