******P*****P**aa
***************aa
****P****P****aaa
**************aaa
**************aaa
a*************aaa
a**************aa
a**************aa
aa*************aa
aa*************aa
aa*************aa
a**************aa
aa*************aa
aa************aaa
aaaa*********aaaa
aaaa********aaaaa
aaa***********aaa
a*************aaa
a**************aa
aa*************aa
aa*************aa
aa*************aa
aaa************aa
aaa************aa
aaaa***********aa
aaaa***********aa
aaaa***********aa
aaa************aa
aaa***1*1*1*1**aa
aa*************aa
a***************a
******1*********a
***********1****a
***1************a
****************a
*******2**2*****a
***************aa
****2******1***aa
a***************a
a***************a
***1*****1******a
***************aa
******1***1***aaa
***************aa
a*******3******aa
***********1****a
******1**1******a
a***************a
a***************a
a***2**2**2**2**a
a****************
aa***1******1****
aa***************
aaa****3**1******
a****************
a***********3****
a*******2********
****1************
**********2*****a
*****1**1***1***a
a****************
a***2******2*****
a*********1******
a****************
a******3**3******
a***************a
aaa*************a
aa*****1*1*1****a
a***************a
aa*************aa
aa*****1****1**aa
aa*************aa
a****1***1****aaa
a**************aa
a***************a
a***2***3**3****a
a***************a
a***************a
a*****2***3*****a
a****2**2**2****a
****************a
********a***3***a
a******aaa*******
a*******aa*******
a********aa******
a*****aaaaaa*****
a*****aaa********
a*****a*********a
a***************a
a***************a
a***************a
a************2**a
a*2*2**********aa
a**************aa
a*************aaa
a****1*****1**aaa
a**************aa
aa**************a
aa**************a
aa**************a
a*******4*******a
a**************aa
a**************aa
a*****3**3*****aa
a***************a
a***************a
aa**************a
aa**************a
aaaa************a
a***************a
a***************a
a*********aaa***a
aaa*****1***aaaaa
aaaaa*********aaa
a**aaaaa********a
a*****aaa*******a
a***************a
a***************a
a***************a
aaa*************a
aaaa***********aa
aa**************a
a***************a
a***************a
a***************a
a**************aa
a**************aa
a**1**1**1**1*aaa
a*************aaa
a***2**2**2****aa
a***************a
aa**************a
aa**************a
aa**************a
a***************a
a***************a
a***************a
aa****3***3****aa
aa***********aaaa
aa************aaa
aa**************a
a***************a
a***************a
a***************a
a********4*******
a****************
a****************
a****************
aa***************
aa***************
aa**2**2**2**2***
aaa**************
aa**************a
a***************a
a***************a
a***************a
a**************aa
a**************aa
a*************aaa
a**************aa
a***************a
aa**************a
aa**************a
aa**************a
aa**************a
a***************a
a***************a
a*******B******aa
a**************aa
*****************
