****P*P*P*P****b
***************b
**************pt
**************bi
**************bi
n*************hu
a**************b
a**************b
rn*************b
ia*****1*******b
so*************b
a**************b
re*************b
ia************gt
irce*********gti
iisf********mdui
sdf**1**1*****bi
a*************qu
a**************b
re*************b
ia*************b
ia*************b
irn************b
iia************b
iire***********b
iiia***********b
iiso***********b
iia************b
iso************b
ia*************b
