******P*****P**aa
***************aa
****P****P****aaa
**************aaa
**************aaa
a*************aaa
a**************aa
a**************aa
aa*************aa
aa*************aa
aa*************aa
a**************aa
aa*************aa
aa************aaa
aaaa*********aaaa
aaaa********aaaaa
aaa***********aaa
a*************aaa
a**************aa
aa*************aa
aa*************aa
aa******B******aa
aaa************aa
aaa************aa
aaaa***********aa
aaaa***********aa
aaaa***********aa
aaa************aa
aaa************aa
aa*************aa
a***************a
****************a
****************a
****************a
****************a
****************a
****************a
****************a
a***************a
a***************a
****************a
****************a
****************a
****************a
****************a
a***************a
****************a
a***************a
a***************a
