******P*****P**a
***************a
****P****P****aa
**************aa
**************aa
a*************aa
a**************a
a**************a
aa*************a
aa*************a
aa*************a
a**************a
aa*************a
aa************aa
aaaa*********aaa
aaaa********aaaa
aaa***********aa
a*************aa
a**************a
aa*************a
aa*************a
aa*************a
aaa************a
aaa****1*******a
aaaa***********a
aaaa***********a
aaaa***2*******a
aaa************a
aaa**********3*a
aa*****3*******a
****************
*******4********
****************
****************
****************
****************
****************
****************
a***************
a***************
****************
****************
****************
****************
****************
a***************
****************
a***************
a***************
